#######################################
#A                               #   ##
# ### ##### ### ### ### ##### ##### # #
#   #     #     # #   #     #     #   #
### ##### ####### # ### ### # ### ### #
#   #     #       # #   #   #   #     #
# ### ### # ######### ### ##### ### ###
#     #   #   #     #     #     #     #
##### # ##### # ### ##### ##### ### # #
#   # #     # #   #     #     #   # # #
# # # ##### # ### ##### ##### ### # # #
# #     #   #     #     #   # #   #   #
# ####### ######### ### # # # # #######
#       #   #     # #   # # # #       #
##### # ### # ### # # ### ### ####### #
#     #     #   #   #     #   #     # #
# ########### ### ####### # ### ### # #
#       #     #   #     # #   #   # # #
### ### # ### # ### ### # ### # ### # #
#   #   #   #   #   #   #     #     #B#
#######################################
