###### B
###### #
#      #
# ## ###
#  #   #
# #### #
# #### #
A      #
########